1111111111111111111111111111111111111111111
1000000000000000P00000000000000000000100001
10000000C0000000010000000011110000000C10001
1000C000011100101E1000000000010000000100001
1000000001000000010000000000010000000000001
1111111111111111111111111111111111111111110
