11111111111111111111111111111
1P000000C00000000000C0000CE01
10111110111110111110111110111
1C000C00000C0C00000C00000C001
10111011101110111011101110111
1C000C0C00C000C0C00C000C0C001
10101110111010111010111010111
1C00C0000C000C0000C0000C00001
11111111111111111111111111111