1111111111111111111
1000000000000000P01
10000000C0000000011
1000C000000000000E1
1000000000000000001
1111111111111111111
